1020 1080 1080 1080 1080 1090 1080 1090
0020 1070 0020 1000 1000 1000 1000 1040
1000 1000 1000 1000 1000 1000 1000 1000
1000 1000 1000 1000 1000 1000 1000 1000
1000 1000 1000 1030 1000 1000 1000 1000
1000 1000 1000 1100 1000 1000 1000 1000
1010 1000 1000 1000 1000 1000 1060 1000
0020 1000 1000 1000 1000 1000 0020 1000
music 01.ogg
info 4 6 Created by Robin Stjerndorff. Maintained by Jerry Liu and Elliot Speck.
step 8 2 map002.map
